#######################################
# Syntax Coloring Map SMARTWAV2
#######################################

#######################################
# Datatypes (KEYWORD1)
#######################################

SMARTWAV2	KEYWORD1	SMARTWAV2

#######################################
# Methods and Functions (KEYWORD2)
#######################################

begin	KEYWORD2
reset	KEYWORD2
sleep	KEYWORD2
standby	KEYWORD2
wake	KEYWORD2
masterGain	KEYWORD2
setDefaultMasterGain	KEYWORD2
masterSampleRate	KEYWORD2
keepSampleRate	KEYWORD2
setBaudrate	KEYWORD2
setDefaultVoiceMsg	KEYWORD2
setDefaultMIDIRelease	KEYWORD2

mount	KEYWORD2
play	KEYWORD2
pause	KEYWORD2
playPause	KEYWORD2
playImme	KEYWORD2
volume	KEYWORD2
panning	KEYWORD2
rewindPlay	KEYWORD2
advanceTo	KEYWORD2
setABPoints	KEYWORD2
loop	KEYWORD2
stop	KEYWORD2
getMount	KEYWORD2
getPlayPause	KEYWORD2
getVolume	KEYWORD2
getPanning	KEYWORD2
getLoop	KEYWORD2
getName	KEYWORD2
getCurrentPoint	KEYWORD2
getABPoints	KEYWORD2
getRemainTime	KEYWORD2
getSizeTime	KEYWORD2
getMonoStereo	KEYWORD2
getBitsPerSample	KEYWORD2
getSampleRate	KEYWORD2

SDFmount	KEYWORD2
SDFgetListDirs	KEYWORD2
SDFgetListFiles	KEYWORD2
SDFgetDirItemName	KEYWORD2
SDFgetFileItemName	KEYWORD2
SDFopenDir	KEYWORD2
SDFgetPath	KEYWORD2
SDFnewDir	KEYWORD2
SDFnewFile	KEYWORD2
SDFeraseDir	KEYWORD2
SDFeraseFile	KEYWORD2
SDFgetFileSize	KEYWORD2
SDFgetFATAttribute	KEYWORD2
SDFgetDateTime	KEYWORD2
SDFsetDateTime	KEYWORD2
SDFrenameDir	KEYWORD2
SDFrenameFile	KEYWORD2
SDFgetFreeTotalSpace	KEYWORD2

SDFopenFile	KEYWORD2
SDFreadFile	KEYWORD2
SDFwriteFile	KEYWORD2
SDFgetPointer	KEYWORD2
SDFsetPointer	KEYWORD2
SDFsaveFile	KEYWORD2
SDFtruncateFile	KEYWORD2
SDFtestErrorFile	KEYWORD2
SDFtestEndFile	KEYWORD2
SDFcloseFile	KEYWORD2

#######################################
# Constants (LITERAL1)
#######################################

SW_R_OK	LITERAL1
SW_R_FAIL	LITERAL1
SW_CH0	LITERAL1
SW_CH1	LITERAL1
SW_CH2	LITERAL1
SW_CH3	LITERAL1
SW_CH4	LITERAL1
SW_CH5	LITERAL1
SW_CH6	LITERAL1
SW_CH7	LITERAL1
SW_CH8	LITERAL1
SW_CH9	LITERAL1
SW_CH10	LITERAL1
SW_CH11	LITERAL1
SW_CH12	LITERAL1
SW_CH13	LITERAL1
SW_CHALL	LITERAL1
SW_READONLY	LITERAL1
SW_WRITEONLY	LITERAL1
SW_READWRITE	LITERAL1
SW_BAUD0	LITERAL1
SW_BAUD1	LITERAL1
SW_BAUD2	LITERAL1
SW_BAUD3	LITERAL1
SW_BAUD4	LITERAL1
SW_F_OK	LITERAL1
SW_F_DISK_ERR	LITERAL1
SW_F_INT_ERR	LITERAL1
SW_F_NOT_READY	LITERAL1
SW_F_NO_FILE	LITERAL1
SW_F_NO_PATH	LITERAL1
SW_F_INVALID_NAME	LITERAL1
SW_F_DENIED	LITERAL1
SW_F_EXIST	LITERAL1
SW_F_INVALID_OBJECT	LITERAL1
SW_F_WRITE_PROTECTED	LITERAL1
SW_F_INVALID_DRIVE	LITERAL1
SW_F_NOT_ENABLED	LITERAL1
SW_F_NO_FILESYSTEM	LITERAL1
SW_F_MKFS_ABORTED	LITERAL1
SW_F_TIMEOUT	LITERAL1
SW_F_LOCKED	LITERAL1
SW_F_NOT_ENOUGH_CORE	LITERAL1
SW_F_TOO_MANY_OPEN_FILES	LITERAL1
SW_F_INVALID_PARAMETER	LITERAL1